# Map file for tile-based game
# (Lines that start with '#' are comments)
# The tiles are:
#   (Space) Empty tile
#   A..Z    Tiles A through Z
#   !       Enemy
#   *       Collectible
D                            C
D                            C
D                            C
D                            C
D                            C
D                            C
D *                   *      C
D I    I      I     *  I    IC
D     *           IIII       C
D    II    *    II         * C
D  *     IIIIII           II C
D II      *           *      C
D      IIIIII         III    C
D           *   IIIIII       C
D     *  IIIIII      *   III C
D    IIII    *   II  IIII    C
D I         III              C
D            *           *   C
HBBBBBBBBBBBBBBBBBBBBBBBBBBBBG